##########
#S.......#
#.######.#
#.#....#.#
#.#.##.#.#
#.#....#.#
#.######.#
#........#
#......E.#
##########
